50 30
31 639
1150 40
0 0 0 0 0 0 0 0 0 0 0 0 0 0 0 0 0 0 0 0 0 0 0 0 0 0 0 0 0 0 0 0 0 0 0 0 0 0 0 0 0 0 0 0 0 0 0 0 0 0 
0 3 3 3 3 3 3 3 3 3 3 6 3 3 3 3 3 6 3 3 3 3 3 3 3 3 3 3 3 6 6 5 5 5 5 5 5 5 5 5 5 5 5 5 5 5 5 5 5 9 
0 3 3 3 3 3 3 3 3 3 3 6 6 3 3 3 6 6 3 3 3 3 3 3 3 3 3 3 3 6 6 5 5 5 5 5 5 5 5 6 6 6 6 6 6 6 6 6 6 6 
0 3 3 3 3 3 3 3 3 3 3 3 6 6 6 6 6 6 3 3 3 3 3 3 3 3 3 3 3 6 6 5 5 5 5 5 5 5 6 6 6 6 6 6 6 6 6 6 6 6 
0 3 3 3 3 3 3 3 6 6 6 6 6 6 6 6 6 6 6 6 6 3 3 3 3 3 3 3 3 6 6 5 5 5 5 5 5 6 6 6 6 6 6 5 5 5 5 5 5 9 
0 3 3 3 3 3 3 6 6 3 3 3 3 6 6 6 3 3 3 3 6 3 3 3 3 3 3 3 3 6 6 6 6 6 6 6 6 6 6 6 6 5 5 5 5 5 5 5 5 0 
0 3 3 3 3 3 3 3 3 3 3 3 3 6 6 6 6 6 3 3 3 3 3 3 3 3 3 3 3 6 6 6 6 6 6 6 6 6 6 6 5 5 5 5 5 5 5 5 5 0 
0 3 3 3 3 3 3 3 3 3 3 6 6 6 3 3 3 6 6 3 3 3 3 3 3 3 3 3 3 6 6 5 5 5 5 5 5 6 6 6 6 5 5 5 5 5 5 5 5 0 
0 3 3 3 3 3 3 3 3 3 6 6 3 3 3 3 3 3 6 3 3 3 3 3 3 3 3 3 3 6 6 5 5 5 5 5 5 5 6 6 6 6 5 5 5 5 5 5 5 0 
0 6 6 6 6 6 6 6 6 6 6 6 6 6 6 6 6 6 6 6 6 6 3 3 3 3 3 3 3 6 6 5 5 5 5 5 5 5 5 6 6 6 6 5 5 5 5 5 5 0 
0 6 6 6 6 6 6 6 6 6 6 6 6 6 6 6 6 6 6 6 6 6 3 3 3 3 3 3 3 6 6 5 5 5 5 5 5 5 5 5 6 6 6 6 6 6 6 6 6 0 
0 2 2 2 2 2 2 2 2 2 2 2 2 2 2 2 2 2 2 2 2 6 6 6 6 6 6 6 6 6 6 5 5 5 5 5 5 5 5 5 5 6 6 6 6 6 6 6 6 0 
0 2 2 2 6 6 6 6 6 6 6 2 2 2 2 2 2 2 2 2 2 6 4 4 4 4 4 4 6 5 5 5 5 5 5 5 5 5 5 5 5 5 5 5 5 5 5 5 5 0 
0 2 2 6 6 6 6 6 6 6 6 6 2 2 2 2 2 2 2 2 2 6 4 4 4 4 4 4 6 5 5 5 5 5 5 5 5 5 5 5 5 5 5 5 5 5 5 5 5 0 
0 2 6 6 6 2 2 2 2 6 6 6 6 2 2 2 2 2 2 2 2 6 4 4 4 4 4 4 6 5 5 5 5 5 5 5 5 5 5 5 5 5 5 5 5 5 5 5 5 0 
0 6 6 6 2 2 2 2 2 2 6 6 6 2 2 2 2 2 2 2 2 6 4 4 4 4 4 4 6 5 5 5 5 5 5 5 5 5 5 5 5 5 5 5 5 5 5 5 5 0 
0 6 6 2 2 2 2 2 2 2 2 6 6 6 2 2 2 2 2 2 2 6 4 4 4 4 4 4 6 5 5 5 5 5 5 5 5 5 5 5 5 5 5 5 5 5 5 5 5 0 
0 6 6 2 2 2 2 2 2 2 2 2 6 6 2 2 2 2 2 2 2 6 4 4 4 4 4 4 6 5 5 5 5 5 5 5 5 5 5 5 5 5 5 5 5 5 5 5 5 0 
0 6 6 2 2 2 2 2 2 2 2 2 6 6 2 2 2 2 2 2 2 6 6 6 6 6 6 6 6 5 5 5 5 5 5 5 5 5 5 5 5 5 5 5 5 5 5 5 5 0 
0 6 6 2 2 2 2 2 2 2 2 6 6 6 2 2 2 2 2 2 2 6 6 1 1 1 1 1 6 6 6 6 6 6 6 6 6 6 6 6 6 6 6 6 6 6 6 6 6 0 
0 6 6 6 2 2 2 2 2 2 6 6 6 6 6 6 6 6 6 6 6 6 6 1 1 1 1 1 6 6 6 6 6 6 6 6 6 6 6 6 6 6 6 6 6 6 6 6 6 0 
0 2 6 6 6 2 2 2 2 6 6 6 6 6 6 6 6 6 6 6 6 6 6 1 1 1 1 1 1 1 1 1 1 1 1 1 1 1 6 6 6 6 1 1 1 1 1 1 1 0 
0 2 6 6 6 6 6 6 6 6 6 2 2 2 2 2 2 2 2 2 2 6 6 1 1 1 1 1 1 1 1 1 1 1 1 1 1 6 6 6 6 6 6 1 1 1 1 1 1 0 
0 2 2 2 6 6 6 6 6 6 6 2 2 2 2 2 2 2 2 2 2 6 6 1 1 1 1 1 1 1 1 1 1 1 1 1 6 6 6 6 6 6 6 6 1 1 1 1 1 0 
0 2 2 2 2 6 6 6 6 2 2 2 2 2 2 2 2 2 2 2 2 6 6 1 1 1 1 1 1 1 1 1 1 1 1 6 6 6 6 6 6 6 6 6 6 1 1 1 1 0 
0 2 2 2 2 2 2 2 2 2 2 2 2 2 2 2 2 2 2 2 2 6 6 1 1 1 1 1 1 1 1 1 1 1 6 6 6 6 6 6 6 6 6 6 6 6 1 1 1 0 
0 2 2 2 2 2 2 2 2 2 2 2 2 2 2 2 2 2 2 2 2 6 6 1 1 1 1 1 1 1 1 1 1 1 1 6 6 6 6 6 6 6 6 6 6 1 1 1 1 0 
0 6 6 6 6 6 6 6 6 6 6 6 6 6 6 6 6 6 6 6 6 6 6 1 1 1 1 1 1 1 1 1 1 1 1 1 6 6 6 6 6 6 6 6 1 1 1 1 1 0 
0 6 6 6 6 6 6 6 6 6 6 6 6 6 6 6 6 6 6 6 6 6 6 1 1 1 1 1 1 1 1 1 1 1 1 1 1 6 6 6 6 6 6 1 1 1 1 1 1 0 
0 0 0 0 0 0 0 0 0 0 0 0 0 0 0 0 0 0 0 0 0 0 0 0 0 0 0 0 0 0 0 0 0 0 0 0 0 0 0 0 0 0 0 0 0 0 0 0 0 0