50 30
-2 620
1150 47
00 00 00 00 00 00 00 00 00 00 00 00 00 00 00 00 00 00 00 00 00 00 00 00 00 00 00 00 00 00 00 00 00 00 00 00 00 00 00 00 00 00 00 00 00 00 00 00 00 00 
00 05 05 05 05 05 05 05 05 05 05 05 05 05 05 05 00 00 00 00 05 05 05 13 13 13 13 05 05 05 05 05 05 05 05 05 05 05 05 00 05 05 05 05 05 05 05 05 05 09 
00 05 05 05 05 05 05 05 05 05 05 05 05 05 05 05 05 05 05 05 05 05 05 13 13 13 13 05 05 05 05 05 05 05 05 05 05 05 05 00 05 05 05 05 05 05 05 05 05 05 
00 05 05 05 05 05 05 05 05 05 05 05 05 05 05 05 05 05 05 05 05 05 05 13 13 13 13 11 11 11 11 11 11 11 05 05 05 05 05 00 05 05 11 11 11 11 05 05 05 05 
00 05 05 05 05 05 05 05 05 05 05 05 05 05 05 05 05 05 05 05 05 05 05 05 05 05 05 05 11 11 11 11 11 11 05 05 05 05 00 00 05 05 05 11 05 05 05 05 05 09 
00 05 05 05 05 05 05 11 11 11 11 11 11 11 11 11 11 11 11 11 11 11 05 05 05 05 05 05 05 05 05 05 11 11 05 05 05 05 00 05 05 05 05 11 05 05 05 05 05 00 
00 05 05 05 05 05 11 11 11 11 11 11 11 11 11 11 11 11 11 11 11 11 05 05 05 05 05 05 05 05 05 05 11 11 05 05 05 05 00 05 05 05 05 11 05 05 05 05 05 00 
00 05 05 05 05 05 11 11 11 11 11 11 11 11 11 11 11 11 11 11 11 11 05 05 05 05 05 05 05 05 05 05 11 11 11 05 05 05 00 05 05 05 05 11 05 05 05 05 05 00 
00 05 05 05 05 05 05 05 05 05 05 05 05 05 05 05 05 05 05 05 05 11 11 11 11 11 11 11 11 11 11 11 11 11 11 11 05 05 05 05 05 05 05 11 05 05 05 05 05 00 
00 05 05 05 05 05 11 11 11 11 05 05 05 05 05 05 05 05 05 05 05 11 11 11 11 11 11 11 11 11 11 11 11 11 11 11 11 05 11 11 11 11 11 11 05 05 05 05 05 00 
00 05 05 05 11 11 11 11 11 11 11 11 11 11 11 11 11 11 11 11 11 11 11 05 05 05 05 05 05 05 05 05 05 05 11 11 11 11 11 05 05 05 05 00 05 05 00 00 00 00 
00 05 05 05 11 11 11 11 11 11 11 11 11 11 11 11 11 11 11 11 11 11 11 05 05 05 05 05 05 05 05 05 05 05 05 11 11 11 11 05 05 05 05 00 00 00 00 05 05 00 
00 05 05 05 11 11 13 13 05 05 05 05 05 05 05 05 05 05 13 05 05 11 11 05 05 05 05 05 05 05 05 05 05 05 05 05 11 11 11 05 05 05 05 05 05 05 05 05 05 00 
00 05 05 05 11 11 13 13 05 05 05 05 05 05 05 05 05 05 05 05 05 11 11 11 05 05 00 00 00 00 05 05 05 05 05 05 05 11 11 11 05 05 05 05 05 05 05 05 05 00 
00 05 11 11 11 11 13 05 05 05 05 05 05 05 05 05 05 05 05 05 05 11 11 11 05 05 00 00 00 00 05 05 05 05 05 05 05 05 11 11 05 05 05 05 05 05 05 05 05 00 
00 05 11 11 11 12 12 12 12 12 12 12 12 12 12 12 12 12 05 05 05 05 05 11 05 05 05 05 05 05 05 05 05 05 05 05 05 05 11 11 05 05 05 05 05 05 05 05 05 00 
00 05 11 11 12 12 12 12 12 12 12 12 12 12 12 12 12 12 05 05 05 05 05 11 05 05 05 05 05 05 05 05 05 05 05 05 05 05 11 11 05 05 05 05 05 05 05 05 05 00 
00 05 11 11 12 12 00 00 00 12 12 00 00 00 00 00 12 12 05 05 05 05 05 11 05 05 05 05 05 05 05 05 05 05 05 11 11 11 11 11 05 05 05 05 05 05 05 05 05 00 
00 05 11 11 12 12 00 05 05 12 05 12 05 05 05 00 12 12 05 05 05 05 05 11 05 05 05 05 05 11 11 11 11 11 11 11 11 11 11 11 11 05 05 05 05 05 11 05 05 00 
00 05 11 11 05 12 05 05 05 12 05 12 05 05 05 05 12 05 05 05 05 05 05 11 05 05 05 05 05 11 11 11 11 11 11 11 11 11 11 11 11 05 05 05 05 11 11 05 05 00 
00 05 11 11 11 05 05 05 05 12 12 12 12 05 05 05 05 05 05 05 05 05 05 11 05 05 05 05 05 11 11 05 05 05 05 13 05 05 11 11 11 11 05 05 11 11 11 11 05 00 
00 05 05 05 11 11 11 05 05 12 05 05 12 05 05 05 11 11 11 11 11 11 11 11 11 11 11 11 11 11 11 05 05 05 13 05 13 05 11 11 11 11 11 11 11 11 11 11 11 00 
00 05 05 05 05 05 11 11 11 12 12 12 12 12 05 05 11 11 11 11 11 11 11 11 11 11 11 11 11 11 11 05 05 05 05 13 05 05 11 11 05 05 11 11 11 05 05 05 05 00 
00 05 05 05 05 05 05 05 05 05 05 05 05 05 05 11 11 11 11 05 05 05 05 05 05 11 11 11 11 11 11 11 11 11 11 11 11 11 11 11 05 05 11 11 05 05 05 05 05 00 
00 05 05 05 05 05 05 05 05 05 05 05 05 05 05 11 11 11 11 05 05 05 05 05 05 05 05 05 05 05 05 05 05 05 05 05 05 05 05 05 05 05 11 05 05 05 05 05 05 00 
09 05 05 05 05 05 05 05 05 05 05 05 05 05 05 11 11 11 11 05 05 05 05 05 05 05 05 05 05 05 05 05 05 05 05 05 05 05 05 05 05 05 11 05 05 05 05 05 05 00 
11 05 05 05 05 05 05 05 05 05 05 05 05 05 05 11 11 11 11 05 05 05 05 05 05 05 05 05 05 05 05 05 05 05 05 05 05 05 05 05 05 05 11 05 05 05 05 05 05 00 
11 11 11 11 11 11 11 11 11 11 11 11 11 11 11 11 11 11 11 05 00 00 00 00 05 05 05 05 05 05 05 05 05 05 05 05 05 05 05 05 05 05 11 11 05 05 05 05 05 00 
09 11 11 11 11 11 11 11 11 11 11 11 11 11 11 11 11 11 11 05 00 00 00 00 05 05 05 05 05 05 05 05 05 05 05 05 05 05 05 05 05 05 11 11 05 05 05 05 05 00 
00 00 00 00 00 00 00 00 00 00 00 00 00 00 00 00 00 00 00 00 00 00 00 00 00 00 00 00 00 00 00 00 00 00 00 00 00 00 00 00 00 00 00 00 00 00 00 00 00 00